##.#.....#.#
##...#.#...#
#......#...#
##...#...#.#
#..#.#.#...#
#..#.......#
#..#...#...#
##.#.#...#.#
#..#.....#.#
##...#.#.#.#
\robot 2 0
\robot 3 0
\robot 4 0