#........#
#..#.#...#
##.#.#.#.#
##.......#
##.....#.#
#..#...#.#
#..#.....#
#........#
\robot 1 0
\robot 8 0