#......#
##...#.#
#..#####
#....#.#
##.....#
##.#.#.#
\robot 2 0
